{"tiles": [[ 2,2,2,2,2,2,2,2,2,2,2,2,2,2,2,2,2,2,2,2,2,2,2,2,2,2,2,2,2,2],
2,2,2,2,2,2,2,2,2,2,2,2,2,2,2,2,2,2,2,2,2,2,2,2,2,2,2,2,2,2],
2,2,2,2,2,2,2,2,2,2,2,2,2,2,2,2,2,2,2,2,2,2,2,2,2,2,2,2,2,2],
2,2,2,2,2,2,2,2,2,2,2,2,2,2,2,2,2,2,2,2,2,2,2,2,2,2,2,2,2,2],
2,2,2,2,2,2,2,2,2,2,2,2,2,2,2,2,2,2,2,2,2,2,2,2,2,2,2,2,2,2],
2,2,2,2,2,2,2,2,5,5,5,5,5,5,5,5,5,5,5,2,2,2,2,2,2,2,2,2,2,2],
2,2,2,2,2,2,2,2,5.5,3,5,3,5.5,3,5.5,3,5,3,5.5,2,2,2,2,2,2,2,2,2,2,2],
2,2,2,2,2,3,3,3,11,5,11,5,11,5,11,5,11,5,11,3,3,3,2,2,2,2,2,2,2,2],
2,2,2,2,2,3,1,3,5.5,3,5,3,5.5,3,5.5,3,5,3,5.5,3,1,3,2,2,2,2,2,2,2,2],
2,2,2,2,2,3,12,9.6,5,5,5,5,5,11,5,5,5,5,5,9.6,12,3,2,2,2,2,2,2,2,2],
2,2,2,2,2,3,3,3,3,2,2,2,2,5.4,2,2,2,2,3,3,3,3,2,2,2,2,2,2,2,2],
2,2,2,2,2,2,2,2,2,2,2,2,2,9.3,2,2,2,2,2,2,2,2,2,2,2,2,2,2,2,2],
2,2,2,2,2,2,2,2,2,2,2,2,2,5.2,2,2,2,2,2,2,2,2,2,2,2,2,2,2,2,2],
2,2,2,2,2,2,2,2,2,2,2,2,2,9.1,2,2,2,2,2,2,2,2,2,2,2,2,2,2,2,2],
2,2,2,2,2,2,2,2,2,2,2,2,2,10,2,2,2,2,2,2,2,2,2,2,2,2,2,2,2,2],
2,2,2,2,2,3,3,3,3,3,3,3,3,3,3,3,3,3,3,3,3,3,2,2,2,2,2,2,2,2],
2,2,2,2,2,2,2,2,2,2,2,2,2,6,2,2,2,2,2,2,2,2,2,2,2,2,2,2,2,2],
2,2,2,2,2,2,2,2,2,2,2,2,2,5.1,2,2,2,2,2,2,2,2,2,2,2,2,2,2,2,2],
2,2,2,2,2,2,2,2,2,2,2,2,2,9.2,2,2,2,2,2,2,2,2,2,2,2,2,2,2,2,2],
2,2,2,2,2,2,2,2,2,2,2,2,2,1,1,2,2,2,2,2,2,2,2,2,2,2,2,2,2,2],
2,2,2,2,2,2,2,2,2,2,2,2,2,5.3,2,2,2,2,2,2,2,2,2,2,2,2,2,2,2,2],
2,2,2,2,2,2,2,2,2,2,2,2,2,9.4,2,2,2,2,2,2,2,2,2,2,2,2,2,2,2,2],
2,2,2,2,2,2,2,2,2,2,2,2,2,1,1,1,1,1,5.6,9.5,12,2,2,2,2,2,2,2,2,2],
2,2,2,2,2,2,2,2,2,2,2,2,2,1,2,2,2,2,2,2,2,2,2,2,2,2,2,2,2,2],
2,2,2,2,2,2,2,2,2,2,2,2,2,5.4,2,2,2,2,2,2,2,2,2,2,2,2,2,2,2,2],
2,2,2,2,2,2,2,2,2,2,2,2,2,2,2,2,2,2,2,2,2,2,2,2,2,2,2,2,2,2],
2,2,2,2,2,2,2,2,2,2,2,2,2,2,2,2,2,2,2,2,2,2,2,2,2,2,2,2,2,2],
2,2,2,2,2,2,2,2,2,2,2,2,2,2,2,2,2,2,2,2,2,2,2,2,2,2,2,2,2,2],
2,2,2,2,2,2,2,2,2,2,2,2,2,2,2,2,2,2,2,2,2,2,2,2,2,2,2,2,2,2],
2,2,2,2,2,2,2,2,2,2,2,2,2,2,2,2,2,2,2,2,2,2,2,2,2,2,2,2,2,2],
],
}