{
    "tiles" :[
              [2,2,2,2,2,2,2,2,2,2,2,2,2,2,2,2,2,2,2,2,2],
              [2,2,2,2,2,2,2,2,2,2,2,2,2,2,2,2,2,2,2,2,2],
              [2,2,2,2,2,2,2,2,2,2,2,2,2,2,2,2,2,2,2,2,2],
              [2,2,2,2,2,2,2,2,2,2,2,2,2,2,2,2,2,2,2,2,2],
              [2,2,2,2,2,2,2,2,2,2,2,2,2,2,2,2,2,2,2,2,2],
              [2,2,2,2,2,2,2,2,2,2,2,2,2,2,2,2,2,2,2,2,2],
              [2,2,2,2,2,2,2,2,2,2,2,2,2,2,2,2,2,2,2,2,2],
              [2,2,2,2,2,2,2,2,2,2,2,2,2,2,2,2,2,2,2,2,2],
              [2,2,2,2,2,2,2,2,2,12,2,2,2,2,2,2,2,2,2,2,2],
              [2,2,2,2,2,2,2,2,3,1,3,2,2,2,2,2,2,2,2,2,2],
              [2,2,2,2,2,2,2,2,3,1,3,3,3,3,3,3,3,2,2,2,2],
              [2,2,2,2,2,2,2,2,3,1,1,1,1,1,1,1,3,2,2,2,2],
              [2,2,2,2,2,2,2,2,3,1,1,1,1,1,1,1,3,2,2,2,2],
              [2,2,2,2,2,2,2,2,3,3,3,3,3,3,3,1,3,2,2,2,2],
              [2,2,2,2,2,2,2,2,2,3,1,1,1,1,1,1,3,2,2,2,2],
              [2,2,2,2,2,2,2,2,2,3,1,3,3,3,3,3,3,2,2,2,2],
              [2,2,2,2,2,2,2,2,2,3,1,3,2,2,2,2,2,2,2,2,2],
              [2,2,2,2,2,2,2,2,2,3,1,3,2,2,2,2,2,2,2,2,2],
              [2,2,2,2,2,2,2,2,2,3,1,3,2,2,2,2,2,2,2,2,2],
              [2,2,2,2,2,2,2,2,2,3,6,3,2,2,2,2,2,2,2,2,2],
              [2,2,2,2,2,2,2,2,2,3,3,3,2,2,2,2,2,2,2,2,2],
              [2,2,2,2,2,2,2,2,2,2,2,2,2,2,2,2,2,2,2,2,2],
              [2,2,2,2,2,2,2,2,2,2,2,2,2,2,2,2,2,2,2,2,2],
              [2,2,2,2,2,2,2,2,2,2,2,2,2,2,2,2,2,2,2,2,2],
              [2,2,2,2,2,2,2,2,2,2,2,2,2,2,2,2,2,2,2,2,2],
              [2,2,2,2,2,2,2,2,2,2,2,2,2,2,2,2,2,2,2,2,2],
              ],
    "targetScore" : 1000,
  "moves" : 15,
}
