{"tiles": [[ 2,2,2,2,2,2,2,2,2,2,2,2,3,3,3,2,2,2,2,2,2,2,2,2,2,2,2,2,2,2],
2,2,2,2,2,2,2,2,2,2,2,2,3,1,3,2,2,2,2,2,2,2,2,2,2,2,2,2,2,2],
2,2,2,2,2,2,2,2,2,2,2,2,3,1,3,2,2,2,2,2,2,2,2,2,2,2,2,2,2,2],
2,2,2,2,2,2,2,2,2,2,2,2,3,1,3,2,2,2,2,2,2,2,2,2,2,2,2,2,2,2],
2,2,2,2,2,2,2,2,2,2,2,2,3,11,3,2,2,2,2,2,2,2,2,2,2,2,2,2,2,2],
2,2,2,2,2,2,2,2,2,2,2,2,3,1,3,2,2,2,2,2,2,2,2,2,2,2,2,2,2,2],
2,2,2,2,2,2,2,2,2,2,2,2,3,9,3,2,2,2,2,2,2,2,2,2,2,2,2,2,2,2],
2,2,2,2,2,2,2,2,2,2,2,2,3,6,3,3,3,2,3,3,3,3,3,3,3,2,2,2,2,2],
2,2,2,2,2,2,2,2,2,2,2,2,3,1,1,1,3,2,3,1,1,5.1,9.2,12,3,2,2,2,2,2],
2,2,3,3,3,3,3,3,3,3,3,3,3,1,3,3,3,2,3,1,1,1,1,9.2,3,2,2,2,2,2],
2,2,3,1,1,1,1,1,1,1,11.1,1,1,1,3,2,2,2,3,1,1,11.1,1,1,3,2,2,2,2,2],
2,2,3,3,3,1,3,3,3,3,3,3,3,3,3,3,3,3,3,1,1,1,1,1,3,2,2,2,2,2],
2,2,3,1,1,1,1,1,1,1,11.1,1,1,1,1,1,1,1,1,1,1,3,1,1,3,2,2,2,2,2],
2,2,3,3,3,3,3,3,3,3,3,3,3,3,3,3,3,3,3,1,1,1,4,1,3,2,2,2,2,2],
2,2,3,1,1,1,1,1,1,1,11.1,1,1,1,1,1,1,1,1,1,1,3,1,1,3,2,2,2,2,2],
2,2,3,3,3,1,3,3,3,3,3,3,3,3,3,3,3,3,3,1,1,1,1,1,3,2,2,2,2,2],
2,2,3,1,1,1,1,1,11.1,1,1,1,1,1,3,2,2,2,3,1,1,1,1,1,3,2,2,2,2,2],
2,2,3,3,3,3,3,3,3,3,3,3,3,1,3,2,2,2,3,1,1,11.1,1,1,3,2,2,2,2,2],
2,2,2,2,2,2,2,2,2,2,2,2,3,1,3,3,3,2,3,1,1,1,1,9.1,3,2,2,2,2,2],
2,2,2,2,2,2,2,2,2,2,2,2,3,1,1,3,3,2,3,1,1,5.2,9.1,12,3,2,2,2,2,2],
2,2,2,2,2,2,2,2,2,2,2,2,3,1,3,3,3,2,3,3,3,3,3,3,3,2,2,2,2,2],
2,2,2,2,2,2,2,2,2,2,2,2,3,10,3,2,2,2,2,2,2,2,2,2,2,2,2,2,2,2],
2,2,2,2,2,2,2,2,2,2,2,2,3,9,3,2,2,2,2,2,2,2,2,2,2,2,2,2,2,2],
2,2,2,2,2,2,2,2,2,2,2,2,3,1,3,2,2,2,2,2,2,2,2,2,2,2,2,2,2,2],
2,2,2,2,2,2,2,2,2,2,2,2,3,11,3,2,2,2,2,2,2,2,2,2,2,2,2,2,2,2],
2,2,2,2,2,2,2,2,2,2,2,2,3,1,3,2,2,2,2,2,2,2,2,2,2,2,2,2,2,2],
2,2,2,2,2,2,2,2,2,2,2,2,3,1,3,2,2,2,2,2,2,2,2,2,2,2,2,2,2,2],
2,2,2,2,2,2,2,2,2,2,2,2,3,1,3,2,2,2,2,2,2,2,2,2,2,2,2,2,2,2],
2,2,2,2,2,2,2,2,2,2,2,2,3,1,3,2,2,2,2,2,2,2,2,2,2,2,2,2,2,2],
2,2,2,2,2,2,2,2,2,2,2,2,3,3,3,2,2,2,2,2,2,2,2,2,2,2,2,2,2,2],
],
    "texts" : [
               {
               "text":"Chapter 4: Obstacle",
               "coor":[7,16],
               "size":20
               },
               {
               "text":"Chapter 4: Obstacle",
               "coor":[22,16],
               "size": 20
               },
               ],
}