{
    "tiles" : [ [3, 3, 3, 3, 3, 3, 3, 3, 3, 3, 3, 3, 3, 3, 1, 3, 3, 3, 3, 3, 1, 3, 3, 3, 3, 3, 3, 3, 3, 3 ],
                [3, 3, 3, 3, 3, 3, 3, 3, 3, 3, 3, 3, 3, 3, 1, 3, 3, 3, 3, 3, 1, 3, 3, 3, 3, 3, 3, 3, 3, 3 ],
                [3, 3, 3, 3, 3, 3, 3, 3, 3, 3, 3, 3, 3, 3, 1, 3, 3, 3, 3, 3, 1, 3, 3, 3, 3, 3, 3, 3, 3, 3 ],
                [3, 3, 3, 3, 3, 3, 3, 3, 3, 3, 3, 3, 3, 3, 1, 3, 3, 3, 3, 3, 1, 3, 3, 3, 3, 3, 3, 3, 3, 3 ],
                [3, 3, 3, 3, 3, 3, 3, 3, 3, 3, 3, 3, 3, 3, 1, 3, 3, 3, 3, 3, 1, 3, 3, 3, 3, 3, 3, 3, 3, 3 ],
                [3, 3, 3, 3, 3, 3, 3, 3, 3, 3, 3, 3, 3, 3, 1, 3, 3, 3, 3, 3, 1, 3, 3, 3, 3, 3, 3, 3, 3, 3 ],
                [3, 3, 3, 3, 3, 3, 3, 3, 3, 3, 3, 3, 3, 3, 1, 3, 3, 3, 3, 3, 1, 3, 3, 3, 3, 3, 3, 3, 3, 3 ],
                [3, 3, 3, 3, 3, 3, 3, 3, 3, 3, 3, 3, 3, 3, 1, 3, 3, 3, 3, 3, 1, 3, 3, 3, 3, 3, 3, 3, 3, 3 ],
                [3, 3, 3, 3, 3, 3, 3, 3, 3, 3, 3, 3, 3, 3, 3, 3, 3, 3, 3, 3, 9, 3, 3, 3, 3, 3, 3, 3, 3, 3 ],
                [2, 2, 2, 2, 2, 2, 3, 2, 1, 1, 1, 1, 1, 1, 1, 3, 5.3, 1, 1, 1, 1, 1, 1, 5.3, 2, 2, 2, 2, 2, 2 ],
                [2, 2, 2, 2, 2, 2, 3, 2, 1, 3, 3, 3, 3, 3, 1, 3, 1, 1, 1, 1, 1, 1, 1, 11, 2, 2, 2, 2, 2, 2 ],
                [2, 2, 2, 2, 2, 2, 3, 2, 1, 3, 1, 1, 1, 3, 1, 3, 1, 1, 1, 11, 1, 1, 1, 1, 2, 2, 2, 2, 2, 2 ],
                [2, 2, 2, 2, 2, 2, 3, 2, 1, 1, 5.4, 4, 1, 1, 1, 9.3, 1, 1, 1, 1, 1, 11, 1, 1, 2, 2, 2, 2, 2, 2 ],
                [2, 2, 2, 2, 2, 2, 3, 2, 1, 3, 1, 1, 1, 3, 1, 3, 1, 1, 1, 1, 11, 1, 1, 1, 2, 2, 2, 2, 2, 2 ],
                [2, 2, 2, 2, 2, 2, 3, 2, 1, 3, 3, 3, 3, 3, 1, 3, 1, 1, 11, 1, 1, 1, 1, 1, 2, 2, 2, 2, 2, 2 ],
                [2, 2, 2, 2, 2, 2, 3, 2, 1, 1, 1, 1, 1, 1, 1, 3, 1, 1, 1, 1, 1, 1, 1, 1, 2, 2, 2, 2, 2, 2 ],
                [2, 2, 2, 2, 2, 3, 3, 9.4, 9.4, 3, 3, 3, 3, 3, 3, 3, 1, 11, 1, 11, 1, 1, 1, 1, 2, 2, 2, 2, 2, 2 ],
                [2, 2, 2, 2, 2, 3, 1, 1, 1, 1, 3, 1, 1, 1, 1, 1, 1, 1, 1, 1, 1, 1, 1, 1, 2, 2, 2, 2, 2, 2 ],
                [2, 2, 2, 2, 2, 3, 1, 1, 1, 1, 3, 1, 1, 1, 1, 1, 11, 1, 1, 1, 1, 1, 1, 1, 2, 2, 2, 2, 2, 2 ],
                [2, 2, 2, 2, 2, 3, 1, 1, 4, 1, 3, 1, 1, 3, 3, 3, 3, 3, 3, 3, 3, 3, 3, 3, 2, 2, 2, 2, 2, 2 ],
                [2, 2, 2, 2, 2, 3, 5.5, 1, 5.5, 5.5, 3, 1, 1, 3, 5.1, 1, 5.1, 1, 5.1, 1, 5.1, 1, 5.1, 1, 2, 2, 2, 2, 2, 2 ],
                [2, 2, 2, 2, 2, 3, 5, 4, 5.5, 5.5, 3, 1, 11, 3, 2, 1, 2, 1, 2, 1, 2, 11, 2, 1, 2, 2, 2, 2, 2, 2 ],
                [2, 2, 2, 2, 2, 3, 5.5, 1, 1, 5.5, 3, 1, 1, 3, 5.1, 1, 5.1, 1, 5.1, 1, 5.1, 1, 5.1, 1, 2, 2, 2, 2, 2, 2 ],
                [2, 2, 2, 2, 2, 3, 5.5, 5.5, 5.5, 5.5, 3, 1, 1, 9.2, 1, 1, 2, 1, 2, 11, 2, 1, 2, 1, 2, 2, 2, 2, 2, 2 ],
                [2, 2, 2, 2, 2, 3, 1, 1, 1, 1, 3, 1, 1, 3, 5.1, 1, 5.1, 1, 5.1, 1, 5.1, 1, 5.1, 1, 2, 2, 2, 2, 2, 2 ],
                [2, 2, 2, 2, 2, 3, 5.5, 1, 5.5, 5.5, 3, 1, 1, 3, 2, 1, 2, 11, 2, 1, 2, 1, 2, 1, 2, 2, 2, 2, 2, 2 ],
                [2, 2, 2, 2, 2, 3, 5.5, 1, 5.5, 5.5, 3, 11, 1, 3, 5.1, 11, 5.1, 1, 5.1, 1, 5.1, 1, 5.1, 1, 2, 2, 2, 2, 2, 2 ],
                [2, 2, 2, 2, 2, 3, 5.5, 4, 4, 5.5, 3, 3, 3, 3, 3, 3, 3, 3, 3, 3, 3, 3, 1, 1, 2, 2, 2, 2, 2, 2 ],
                [3, 3, 3, 3, 3, 3, 5.5, 5.5, 5.5, 5.5, 3, 1, 5.2, 3, 3, 3, 3, 3, 3, 3, 3, 3, 1, 1, 2, 2, 2, 2, 2, 2 ],
                [1, 1, 1, 1, 1, 9, 1, 1, 1, 1, 3, 1, 1, 3, 3, 3, 3, 3, 3, 3, 3, 3, 1, 1, 2, 2, 2, 2, 2, 2 ],
                [1, 1, 1, 1, 1, 9, 7, 1, 1, 1, 3, 1, 1, 9.1, 1, 6, 1, 1, 1, 1, 1, 1, 1, 1, 2, 2, 2, 2, 2, 2 ],
                [3, 3, 3, 3, 3, 3, 3, 3, 3, 3, 3, 3, 3, 3, 9, 9, 3, 3, 3, 3, 3, 3, 3, 3, 3, 3, 3, 3, 3, 3 ],
                [3, 3, 3, 3, 3, 3, 3, 3, 3, 3, 3, 3, 3, 3, 1, 1, 3, 3, 3, 3, 3, 3, 3, 3, 3, 3, 3, 3, 3, 3 ],
                [3, 3, 3, 3, 3, 3, 3, 3, 3, 3, 3, 3, 3, 3, 1, 1, 3, 3, 3, 3, 3, 3, 3, 3, 3, 3, 3, 3, 3, 3 ],
                [3, 3, 3, 3, 3, 3, 3, 3, 3, 3, 3, 3, 3, 3, 1, 1, 3, 3, 3, 3, 3, 3, 3, 3, 3, 3, 3, 3, 3, 3 ],
                [3, 3, 3, 3, 3, 3, 3, 3, 3, 3, 3, 3, 3, 3, 1, 1, 3, 3, 3, 3, 3, 3, 3, 3, 3, 3, 3, 3, 3, 3 ],
                [3, 3, 3, 3, 3, 3, 3, 3, 3, 3, 3, 3, 3, 3, 1, 1, 3, 3, 3, 3, 3, 3, 3, 3, 3, 3, 3, 3, 3, 3 ],
                [3, 3, 3, 3, 3, 3, 3, 3, 3, 3, 3, 3, 3, 3, 1, 1, 3, 3, 3, 3, 3, 3, 3, 3, 3, 3, 3, 3, 3, 3 ],
                [3, 3, 3, 3, 3, 3, 3, 3, 3, 3, 3, 3, 3, 3, 1, 1, 3, 3, 3, 3, 3, 3, 3, 3, 3, 3, 3, 3, 3, 3 ],
                [3, 3, 3, 3, 3, 3, 3, 3, 3, 3, 3, 3, 3, 3, 3, 3, 3, 3, 3, 3, 3, 3, 3, 3, 3, 3, 3, 3, 3, 3 ]],

  "targetScore" : 1000,
  "moves" : 15,
    "comment":"//0,1Ground , 2Lava,3Wall, 4Monster, 5Button, 6Birth, 7Key, 8Lock,9door,10 second birth",
}
