{
    "tiles" : [ [3, 3, 3, 3, 3, 3, 3, 3, 3, 3, 3, 3, 3, 3, 1, 3, 3, 3, 3, 3, 3, 3, 3, 3, 3, 3, 3, 3, 3, 3 ],
               [3, 3, 3, 3, 3, 3, 3, 3, 3, 3, 3, 3, 3, 3, 1, 3, 3, 3, 3, 3, 3, 3, 3, 3, 3, 3, 3, 3, 3, 3 ],
               [3, 3, 3, 3, 3, 3, 3, 3, 3, 3, 3, 3, 3, 3, 1, 3, 3, 3, 3, 3, 3, 3, 3, 3, 3, 3, 3, 3, 3, 3 ],
               [3, 3, 3, 3, 3, 3, 3, 3, 3, 3, 3, 3, 3, 3, 1, 3, 3, 3, 3, 3, 3, 3, 3, 3, 3, 3, 3, 3, 3, 3 ],
               [3, 3, 3, 3, 3, 3, 3, 3, 3, 3, 3, 3, 3, 3, 1, 3, 3, 3, 3, 3, 3, 3, 3, 3, 3, 3, 3, 3, 3, 3 ],
               [3, 3, 3, 3, 3, 3, 3, 3, 3, 3, 3, 3, 3, 3, 1, 3, 3, 3, 3, 3, 3, 3, 3, 3, 3, 3, 3, 3, 3, 3 ],
               [3, 3, 3, 3, 3, 3, 3, 3, 3, 3, 3, 3, 3, 3, 1, 3, 3, 3, 3, 3, 3, 3, 3, 3, 3, 3, 3, 3, 3, 3 ],
               [3, 3, 3, 3, 3, 3, 3, 3, 3, 3, 3, 3, 3, 3, 12, 3, 3, 3, 3, 3, 3, 3, 3, 3, 3, 3, 3, 3, 3, 3 ],
               [3, 3, 3, 3, 3, 3, 3, 3, 3, 3, 3, 3, 3, 3, 9.4, 3, 3, 3, 3, 3, 3, 3, 3, 3, 3, 3, 3, 3, 3, 3 ],
               [2, 2, 2, 2, 2, 2, 2, 2, 2, 1, 1, 1, 1, 1, 1, 1, 1, 1, 1, 1, 1, 1, 11, 1, 2, 2, 2, 2, 2, 2 ],
               [2, 2, 2, 2, 2, 2, 2, 2, 2, 1, 1, 1, 1, 1, 1, 1, 1, 1, 1, 1, 1, 1, 1, 1, 2, 2, 2, 2, 2, 2 ],
               [2, 2, 2, 2, 2, 2, 2, 2, 2, 1, 1, 1, 1, 1, 1, 1, 1, 1, 1, 1, 1, 1, 1, 1, 2, 2, 2, 2, 2, 2 ],
               [2, 2, 2, 2, 2, 2, 2, 2, 2, 1, 1, 3, 1, 1, 1, 1, 1, 3, 1, 1, 1, 1, 1, 11.1, 2, 2, 2, 2, 2, 2 ],
               [2, 2, 2, 2, 2, 2, 2, 1, 1, 1, 1, 3, 1, 1, 1, 1, 1, 3, 1, 1, 1, 1, 1, 1, 2, 2, 2, 2, 2, 2 ],
               [2, 2, 2, 2, 2, 2, 2, 1, 1, 1, 1, 3, 1, 1, 1, 1, 1, 3, 1, 1, 1, 1, 11.1, 1, 2, 2, 2, 2, 2, 2 ],
               [2, 2, 2, 2, 2, 2, 2, 1, 1, 4, 1, 3, 1, 1, 4, 1, 1, 3, 1, 1, 1, 1, 1, 1, 2, 2, 2, 2, 2, 2 ],
               [2, 2, 2, 2, 2, 2, 2, 1, 1, 1, 1, 3, 1, 1, 1, 1, 1, 3, 1, 1, 1, 11.1, 1, 1, 2, 2, 2, 2, 2, 2 ],
               [2, 2, 2, 2, 2, 2, 2, 1, 1, 1, 1, 3, 1, 1, 1, 1, 1, 3, 1, 1, 1, 1, 1, 1, 2, 2, 2, 2, 2, 2 ],
               [2, 2, 2, 2, 2, 2, 2, 1, 1, 4, 1, 3, 2, 2, 5, 2, 2, 3, 1, 1, 11.1, 1, 1, 1, 2, 2, 2, 2, 2, 2 ],
               [2, 2, 2, 2, 2, 2, 2, 1, 1, 1, 1, 3, 3, 3, 3, 3, 3, 3, 1, 1, 1, 1, 1, 1, 2, 2, 2, 2, 2, 2 ],
               [2, 2, 2, 2, 2, 2, 2, 1, 1, 1, 1, 5, 3, 1, 5.2, 1, 3, 3, 1, 11.1, 1, 1, 1, 1, 2, 2, 2, 2, 2, 2 ],
               [2, 2, 2, 2, 2, 2, 2, 1, 1, 4, 1, 1, 3, 9.1, 9.1, 9.1, 3, 3, 1, 1, 1, 1, 1, 1, 2, 2, 2, 2, 2, 2 ],
               [2, 2, 2, 2, 2, 2, 2, 1, 1, 1, 1, 1, 3, 1, 1, 11, 3, 3, 11.1, 1, 1, 1, 1, 1, 2, 2, 2, 2, 2, 2 ],
               [2, 2, 2, 2, 2, 2, 2, 1, 1, 1, 1, 1, 3, 1, 1, 1, 3, 3, 1, 1, 1, 1, 1, 1, 2, 2, 2, 2, 2, 2 ],
               [2, 2, 2, 2, 2, 2, 2, 2, 2, 5.4, 3, 3, 3, 11, 1, 1, 3, 3, 3, 9.3, 9.3, 9.3, 3, 3, 2, 2, 2, 2, 2, 2 ],
               [2, 2, 2, 2, 2, 2, 3, 3, 3, 3, 3, 1, 1, 1, 1, 1, 9.2, 1, 2, 1, 1, 1, 1, 1, 2, 2, 2, 2, 2, 2 ],
               [2, 2, 2, 2, 2, 2, 2, 1, 1, 1, 1, 1, 3, 1, 11, 1, 3, 1, 2, 1, 2, 2, 1, 1, 2, 2, 2, 2, 2, 2 ],
               [2, 2, 2, 2, 2, 2, 2, 1, 4, 1, 4, 1, 3, 1, 1, 1, 3, 1, 2, 1, 2, 2, 1, 1, 2, 2, 2, 2, 2, 2 ],
               [2, 2, 2, 2, 2, 2, 2, 1, 1, 1, 1, 1, 3, 1, 1, 1, 3, 1, 2, 1, 5.3, 2, 1, 1, 2, 2, 2, 2, 2, 2 ],
               [2, 2, 2, 2, 2, 2, 2, 1, 1, 1, 1, 1, 3, 1, 1, 1, 3, 1, 2, 2, 2, 2, 1, 1, 2, 2, 2, 2, 2, 2 ],
               [2, 2, 2, 2, 2, 2, 2, 5.1, 1, 1, 1, 5, 3, 1, 6, 1, 3, 1, 1, 1, 1, 1, 1, 1, 2, 2, 2, 2, 2, 2 ],
               [3, 3, 3, 3, 3, 3, 3, 3, 3, 3, 3, 3, 3, 3, 3, 3, 3, 3, 3, 3, 3, 3, 3, 3, 3, 3, 3, 3, 3, 3 ],
               [3, 3, 3, 3, 3, 3, 3, 3, 3, 3, 3, 3, 3, 1, 1, 1, 3, 3, 3, 3, 3, 3, 3, 3, 3, 3, 3, 3, 3, 3 ],
               [3, 3, 3, 3, 3, 3, 3, 3, 3, 3, 3, 3, 3, 1, 1, 1, 3, 3, 3, 3, 3, 3, 3, 3, 3, 3, 3, 3, 3, 3 ],
               [3, 3, 3, 3, 3, 3, 3, 3, 3, 3, 3, 3, 3, 1, 1, 1, 3, 3, 3, 3, 3, 3, 3, 3, 3, 3, 3, 3, 3, 3 ],
               [3, 3, 3, 3, 3, 3, 3, 3, 3, 3, 3, 3, 3, 1, 1, 1, 3, 3, 3, 3, 3, 3, 3, 3, 3, 3, 3, 3, 3, 3 ],
               [3, 3, 3, 3, 3, 3, 3, 3, 3, 3, 3, 3, 3, 1, 1, 1, 3, 3, 3, 3, 3, 3, 3, 3, 3, 3, 3, 3, 3, 3 ],
               [3, 3, 3, 3, 3, 3, 3, 3, 3, 3, 3, 3, 3, 1, 1, 1, 3, 3, 3, 3, 3, 3, 3, 3, 3, 3, 3, 3, 3, 3 ],
               [3, 3, 3, 3, 3, 3, 3, 3, 3, 3, 3, 3, 3, 1, 1, 1, 3, 3, 3, 3, 3, 3, 3, 3, 3, 3, 3, 3, 3, 3 ],
               [3, 3, 3, 3, 3, 3, 3, 3, 3, 3, 3, 3, 3, 3, 3, 3, 3, 3, 3, 3, 3, 3, 3, 3, 3, 3, 3, 3, 3, 3 ] ],

  "targetScore" : 1222,
  "moves" : 15,
    "comment":"//0,1Ground , 2Lava,3Wall, 4Monster, 5Button, 6Birth, 5Key, 8Lock,9door,10 second birth",
}
