{"tiles": [[ 2,2,2,2,2,2,2,2,2,2,2,2,2,2,2,2,2,2,2,2,2,2,2,2,2,2,2,2,2,2],
[2,2,2,2,2,2,2,2,2,2,2,2,2,2,2,2,2,2,2,2,2,2,2,2,2,2,2,2,2,2],
[2,2,2,2,2,2,2,2,2,2,2,2,2,2,2,2,2,2,2,2,2,2,2,2,2,2,2,2,2,2],
[2,2,2,2,2,2,2,2,2,2,2,2,2,2,2,2,2,2,2,2,2,2,2,2,2,2,2,2,2,2],
[2,2,2,2,2,2,2,2,2,2,2,2,2,2,2,2,2,2,2,2,2,2,2,2,2,2,2,2,2,2],
[2,2,2,2,2,2,2,2,2,2,2,2,2,2,2,2,2,2,2,2,3,3,3,2,2,2,2,2,2,2],
[2,2,2,2,2,2,3,3,3,3,3,3,3,3,3,3,3,3,3,3,3,12,3,2,2,2,2,2,2,2],
[2,2,2,2,2,2,3,1,1,1,1,1,1,5.3,1,1,1,1,1,11,3,1,2,2,2,2,2,2,2,2],
[2,2,2,2,2,2,3,1,1,1,1,1,1,4,1,1,1,1,1,1,3,1,2,2,2,2,2,2,2,2],
[2,2,2,2,2,2,3,11,1,3,3,3,3,3,3,3,3,3,11,1,3,1,1,2,2,2,2,2,2,2],
[2,2,2,2,2,2,3,1,1,3,1,1,1,5.2,1,1,1,3,1,1,3,1,2,2,2,2,2,2,2,2],
[2,2,2,2,2,2,3,1,11,3,1,3,3,3,3,3,1,3,1,1,3,11,2,2,2,2,2,2,2,2],
[2,2,2,2,2,2,3,1,1,3,1,3,1,5.1,1,3,1,3,1,1,3,1,2,2,2,2,2,2,2,2],
[2,2,2,2,2,2,3,1,1,9.2,1,9.1,6,3,10,9.1,1,9.2,1,1,9.3,1,1,2,2,2,2,2,2,2],
[2,2,2,2,2,2,3,1,1,3,1,3,1,5.1,1,3,1,3,1,1,3,1,2,2,2,2,2,2,2,2],
[2,2,2,2,2,2,3,1,1,3,1,3,3,3,3,3,1,3,1,1,3,1,2,2,2,2,2,2,2,2],
[2,2,2,2,2,2,3,1,1,3,1,1,1,5.2,1,1,1,3,1,1,3,1,2,2,2,2,2,2,2,2],
[2,2,2,2,2,2,3,1,1,3,3,3,3,3,3,3,3,3,1,1,3,1,1,2,2,2,2,2,2,2],
[2,2,2,2,2,2,3,1,1,1,1,1,1,4,1,1,1,1,1,1,3,1,2,2,2,2,2,2,2,2],
[2,2,2,2,2,2,3,1,1,1,1,1,1,5.3,1,1,1,1,1,1,3,1,2,2,2,2,2,2,2,2],
[2,2,2,2,2,2,3,3,3,3,3,3,3,3,3,3,3,3,3,3,3,12,3,2,2,2,2,2,2,2],
[2,2,2,2,2,2,2,2,2,2,2,2,2,2,2,2,2,2,2,2,3,3,3,2,2,2,2,2,2,2],
[2,2,2,2,2,2,2,2,2,2,2,2,2,2,2,2,2,2,2,2,2,2,2,2,2,2,2,2,2,2],
[2,2,2,2,2,2,2,2,2,2,2,2,2,2,2,2,2,2,2,2,2,2,2,2,2,2,2,2,2,2],
[2,2,2,2,2,2,2,2,2,2,2,2,2,2,2,2,2,2,2,2,2,2,2,2,2,2,2,2,2,2],
[2,2,2,2,2,2,2,2,2,2,2,2,2,2,2,2,2,2,2,2,2,2,2,2,2,2,2,2,2,2],
[2,2,2,2,2,2,2,2,2,2,2,2,2,2,2,2,2,2,2,2,2,2,2,2,2,2,2,2,2,2],
[2,2,2,2,2,2,2,2,2,2,2,2,2,2,2,2,2,2,2,2,2,2,2,2,2,2,2,2,2,2],
[2,2,2,2,2,2,2,2,2,2,2,2,2,2,2,2,2,2,2,2,2,2,2,2,2,2,2,2,2,2],
[2,2,2,2,2,2,2,2,2,2,2,2,2,2,2,2,2,2,2,2,2,2,2,2,2,2,2,2,2,2],
],
    "texts" : [
               {
               "text":"Chapter 7: Escape",
               "coor":[5,22],
               "size":20
               },
               {
               "text":"Chapter 7: Escape",
               "coor":[23,22],
               "size":20
               },
               ],
}